10.ox
.o........
..oo......
..........
..o......o
.o........
.........o
..........
..........
..........
..........
