10.ox
......oo.o
......o...
.ooo.....o
...o......
.oo.......
..........
o....o.o..
.....oo.o.
..........
..........
