20.ox
..oooo.o..o.o...o...
.oo.oo...o..o.ooo...
...oo....oo....o.o.o
.....ooo........o..o
.oo....ooo..o..o...o
..........oo......o.
.....o.........o....
..o...o.o.oo.....o.o
......o..o......o...
.o.o.o....ooo.......
.o...oo...o.o....o..
o..ooo.o...o.oo.....
..................o.
.....oo....oo......o
....o............oo.
.ooo...o.o...oo.o...
......o....o..o.oo..
.....ooo....o..o..oo
...o...o.....o.....o
.oo.o.o......o.....o
